Fase:10
Story: Go ahead to get back (ok, it was a bad pun).
Time:60
Moves:40
Level:21,9
#####################
#.*.#...P.......P...#
#...#...............#
#...#...............#
#...#####...#####...#
#...............#...#
#...........P...#...#
#...P...........#.@.#
#####################