Fase:11
Story: Have you ever felt persecuted? Be careful.
Time:60
Moves:40
Level:21,9
#####################
#.*.#...K.......K...#
#...#...............#
#...#...............#
#...#####...#####...#
#...............#...#
#...........K...#...#
#...K...........#.@.#
#####################