Fase:12
Story: Fear of ghosts? Better get used to it.
Time:60
Moves:9
Level:22,8
......................
....#############.###.
.####........#..###.#.
.#......###.........#.
.####.*.#.#...###...#.
....#...#.#.@.#.#####.
....#####.#####.#.....
......................