Fase:12
Story: Fear of ghosts? Better get used to it.
Time:120
Moves:60
Level:23,14
#######################
#.........#.#.........#
#.G...###.#...#####.#.#
#.....#.#.###.#.G...#.#
#.....#....*#.#.....#.#
#.....#######.#.....#.#
###.###.......#...###.#
#.......########..#.#.#
#####.###.#.#.@##.....#
#...#.#...#.#.#.#####.#
#.###.#.#.#.#.#.......#
#.#...#.#...#.#########
#.......#.#...........#
#######################