Fase:13
Story: Feeling trapped in a maze? See it as a way out.
Time:50
Moves:82
Level:25,12
....####################.
....#.................C#.
....#.E##############..#.
....#..#............#..#.
....#..#..#######.E.#..#.
....#..#..#C....#...#..#.
....#..#..#.*#..#N..#..#.
....#..#..####..#...#..#.
....#..#.......T#...#..#.
....#..##########..M#..#.
....#T..............#@.#.
....####################.
