Fase:15
Story: Every journey begins with the first step. Give yours.
Time:60
Moves:40
Level:21,9
#####################
#.*.#...G...#.......#
#...#.......#.......#
#...#.......#.......#
#...#...#...#...#...#
#.......#.......#...#
#.......#.......#...#
#.......#...G...#.@.#
#####################