Fase:17
Story:The difference between past, present and future is just an illusion.
Time:60
Moves:35
Level:17,11
######-----######
#....##---##....#
#.A...#####...B.#
#.......P.......#
#...............#
#...###...###...#
#...#-#####-#...#
#...#-------#...#
#...####-####...#
#....*.#-#.@....#
########-########