Fase:20
Story: Face your fears face to face.
Time:60
Moves:17
Level:17,19
#################
#...K...*...K...#
##.............##
-##...........##-
--##.........##--
---##.......##---
----##.....##----
-----##...##-----
------#...#------
------#...#------
------#...#------
-----##...##-----
----##.....##----
---##.......##---
--##.........##--
-##...........##-
##.............##
#.......@.......#
#################