Fase:21
Story:I am not afraid of making mistakes and taking chances.
Time:40
Moves:15
Level:11,17
###########
#.........#
#....@....#
#.........#
#....#....#
#....#...S#
##...#B..##
-#...#...#-
-#...#.K.#-
-#...#...#-
##...#..B##
#....#...S#
#....#....#
#.........#
#....*....#
#.........#
###########