Fase:22
Story: We think we are free, but we always follow the same path.
Time:120
Moves:50
Level:25,11
############-############
#@.........###..........#
###.........#......B..###
--#...S...............#--
--##.................##--
---################..#---
--##.................##--
--#...S...............#--
###.........#......B..###
#*.........###..........#
############-############