Fase:23
Story: The future is not of those who live in the past.
Time:120
Moves:50
Level:22,9
######################
#...........#...S....#
#.#.###.###.#......#.#
#.#.#.#.#.#.#.#....#.#
#.#.#.#.#.#.#.#....#.#
#*#.#.#.#.#...#.####.#
#######.#.#####.#.@#.#
#...S...........#....#
######################