Fase:5
Story:A big challenge has been put in your way. Do not give up!
Time:60
Moves:20
Level:20,10
####################
#.S.............S..#
#........#.........#
#......###..#......#
###..###.@..##...###
#......######......#
#........#.........#
#.*...S.........S..#
#........#.........#
####################