Fase:6
Story: Dust, you were amazing. However, new enemies will hinder your journey.
Time:60
Moves:40
Level:25,10
#########################
#.S.....................#
#..................P....#
#......###..............#
###..#####............###
#...@....######.........#
################..#######
#.*...............P.....#
#...........#...........#
#########################