Fase:6
Tile:32
Story:Dust, você foi incrível. Porém, novos inimigos tentarão atrapalhar sua jornada.
Time:60
Moves:40
Level:25,10
#########################
#.S.....................#
#................K......#
#......###..............#
###..#####............###
#...@....######.........#
################..#######
#.*...................K.#
#...........#...........#
#########################