Fase:7
Story: We all have to deal with monsters in and out of life.
Time:60
Moves:27
Level:25,10
#########################
#.......................#
#....G........A.......@.#
#.......................#
#.........C.....C.......#
#.......................#
#######.........T.......#
#.C.................G...#
#..*..#.....#...........#
#########################