Fase:8
Story: Life often seems meaningless. Do you still feel that way here?
Time:60
Moves:30
Level:22,8
......................
....#################.
.####..............B#.
.#S.....###.T..E....#.
.####...#.#######...#.
....#...#.#.@C..#...#.
....#.*.#.#.........#.
....#####.###########.