Fase:9
Story: Don't let obstacles discourage you.
Time:60
Moves:30
Level:22,8
......................
.####################.
.#.*....C...........#.
.#......T...T...S.M.#.
.####...E...C...N...#.
....#.......E.....@.#.
....#################.
......................